и	and
в	at
не	not
он	he
на	on
я	I
что	what
тот	the
быть	be
с	from
а	a
весь	all
это	this
как	as
она	she is
по	by
но	but
они	they
к	to
у	at
ты	you
из	of
мы	we
за	behind
вы	you
так	So
же	the same
от	from
сказать	to tell
этот	this
который	which the
мочь	be able to
человек	human
о	about
один	one
еще	yet
бы	would
такой	such
только	only
себя	himself
свое	his
какой	which
когда	when
уже	already
для	for
вот	here
кто	Who
да	Yes
говорить	speak
год	year
знать	know
мой	my
до	before
или	or
если	if
время	time
рука	arm
нет	no
самый	most
ни	or
стать	become
большой	big
даже	even
другой	other
наш	our
свой	his
ну	Well
под	under
где	Where
дело	a business
есть	there is
сам	himself
раз	time
чтобы	that
два	two
там	there
чем	than
глаз	eye
жизнь	a life
первый	first
день	day
тут	here
во	in
ничто	nothing
потом	later
очень	highly
со	with
хотеть	to want
ли	whether
при	at
голова	head
надо	must
без	without
видеть	see
идти	go
теперь	Now
тоже	also
стоять	stand
друг	friend
дом	house
сейчас	now
можно	can
после	after
слово	word
здесь	here
думать	think
место	a place
спросить	ask
через	across
лицо	face
что	what
тогда	then
ведь	after all
хороший	good
каждый	each
новый	new
жить	live
должный	due
смотреть	look
почему	why
потому	because
сторона	side
просто	just
нога	leg
сидеть	sit
понять	understand
иметь	have
конечный	finite
делать	do
вдруг	all of a sudden
над	above
взять	take
никто	no one
сделать	make
дверь	Door
перед	before
нужный	needed
понимать	understand
казаться	seem
работа	Job
три	three
ваш	your
уж	really
земля	Earth
конец	end
несколько	several
час	hour
голос	vote
город	city
последний	last
пока	till
хорошо	OK
давать	give
вода	water
более	more
хотя	although
всегда	always
второй	second
куда	where
пойти	go
стол	table
ребенок	child
увидеть	see
сила	force
отец	father
женщина	female
машина	a car
случай	happening
ночь	night
сразу	at once
мир	peace
совсем	all
остаться	stay
об	about
вид	view
выйти	go out
дать	give
работать	work
любить	be in love
старый	old
почти	nearly
ряд	row
оказаться	prove
начало	Start
твой	is yours
вопрос	question
много	a lot of
война	war
снова	again
ответить	reply
между	between
подумать	think
опять	again
белый	white
деньги	money
значить	to mean
про	about
лишь	only
минута	minute
жена	wife
посмотреть	look
правда	true
главный	main
страна	a country
свет	shine
ждать	wait
мать	mother
будто	allegedly
никогда	never
товарищ	friend
дорога	road
однако	but
лежать	lie
именно	exactly
окно	window
никакой	no
найти	to find
писать	write
комната	room
Москва	Moscow
часть	part
вообще	at all
книга	book
маленький	little
улица	Street
решить	decide
далеко	long away
душа	soul
чуть	slightly
вернуться	return
утро	morning
некоторый	some
считать	consider
сколько	how
помнить	remember
вечер	evening
пол	floor
таки	nevertheless
получить	get
народ	people
плечо	shoulder
хоть	though
сегодня	Today
бог	God
вместе	together
взгляд	sight
ходить	walk
зачем	what for
советский	Soviet
русский	Russian
бывать	visit
полный	full
прийти	to come
палец	finger
Россия	Russia
любой	any
история	history
наконец	finally
мысль	think
узнать	discover
назад	ago
общий	overall
заметить	observe
словно	like
прошлый	last
уйти	escape
известный	famous
давно	long
слышать	hear
слушать	listen
бояться	fear
сын	a son
нельзя	must not
прямо	straight
долго	long
быстрыйбыстро	bystryybystro
лес	forest
похожий	similar
пора	it is time
пять	five
глядеть	look
оно	it
сесть	take
имя	name
ж	Well
разговор	conversation
тело	body
молодой	young
стена	wall
красный	red
читать	to read
право	right
старик	old man
ранний	early
хотеться	want
мама	Mama
оставаться	stay
высоко	high
путь	way
поэтому	so
совершенно	completely
кроме	Besides
тысяча	one thousand
месяц	month
брать	take
написать	write
целый	all
огромный	huge
начинать	start off
спина	back
настоящий	present
пусть	let
язык	language
точно	exactly
среди	among
чувствовать	feel
сердце	a heart
вести	lead
иногда	sometimes
мальчик	boy
успеть	in time
небо	sky
живой	alive
смерть	death
продолжать	continue
девушка	girl
образ	form
ко	to
забыть	to forget
вокруг	around
письмо	letter
власть	power
черный	the black
пройти	pass the
появиться	to appear
воздух	air
разный	different
выходить	go out
просить	ask
брат	brother
собственный	own
отношение	attitude
затем	then
пытаться	try
показать	show
вспомнить	remember
система	system
четыре	four
квартира	apartment
держать	Keep
также	also
любовь	love
солдат	soldier
откуда	from whence
чтоб	to
называть	call
третий	the third
хозяин	master
вроде	like
уходить	leave
подойти	come up
поднять	pick up
особенно	special
спрашивать	ask
начальник	Chief
оба	both
бросить	throw
школа	school
парень	guy
кровь	blood
двадцать	twenty
солнце	the sun
неделя	a week
послать	send
находиться	be
ребята	guys
поставить	put
встать	up
например	eg
шаг	step
мужчина	Man
равно	equally
нос	nose
мало	few
внимание	Attention
капитан	captain
ухо	an ear
туда	there
сюда	here
играть	play
следовать	to follow
рассказать	tell
великий	great
действительно	really
слишком	too
тяжёлый	heavy
спать	sleep
оставить	retain
войти	to come in
длинный	a long
чувство	feeling
молчать	to be silent
рассказывать	narrate
отвечать	answer
становиться	become
остановиться	stay
берег	Coast
семья	a family
искать	search
генерал	Gen.
момент	moment
десять	ten
начать	to begin
следующий	following
личный	private
труд	work
верить	believe
группа	Group
немного	Little
впрочем	however
видно	it is seen
являться	appear
муж	husband
разве	really
движение	motion
порядок	order
ответ	answer
тихо	quiet
знакомый	friend
газета	newspaper
помощь	help
сильный	strong
скорый	speedy
собака	dog
дерево	tree
снег	snow
сон	sleep
смысл	meaning
смочь	be able to
против	against
бежать	run
двор	court
форма	the form
простой	plain
приехать	come
иной	other
кричать	shout
возможность	opportunity
общество	society
зелёный	green
грудь	chest
угол	angle
открыть	open
происходить	take place
ладно	okay
черный	the black
век	century
карман	pocket
ехать	go
немец	German
наверное	probably
губа	lip
дядя	uncle
приходить	come
часто	often
домой	home
огонь	Fire
писатель	writer
армия	army
состояние	state
зуб	tooth
очередь	queue
кой	Coy
подняться	up
камень	a rock
гость	a guest
показаться	sound
ветер	wind
собираться	collect
попасть	get
принять	to accept
сначала	at first
либо	or
поехать	go
услышать	hear
уметь	be able to
случиться	happen
странный	strange
единственный	only
рота	company
закон	law
коротко	short
море	sea
добрый	kind
темный	dark
гора	mountain
врач	doctor
край	edge
стараться	try
лучший	best
река	river
военный	military
мера	measure
страшный	terrible
вполне	well
звать	call for
произойти	occur
вперед	forward
медленно	slow
возле	near
никак	in no way
заниматься	do
действие	act
довольно	pretty
вещь	thing
необходимый	necessary
ход	course
боль	pain
судьба	fate
причина	cause
положить	put
едва	barely
черта	feature
девочка	girl
легко	easily
волос	hair
купить	buy
номер	number
основной	main
широкий	wide
умереть	die
плохо	badly
глава	chapter
красивый	beautiful
серый	gray
пить	drink
командир	commander
обычно	usually
партия	the consignment
проблема	problem
страх	fear
проходить	pass
ясно	clear
снять	shoot
бумага	paper
герой	hero
пара	couple
государство	state
деревня	village
речь	speech
начаться	to begin
средство	means
положение	position
связь	communication
скоро	soon
небольшой	small
представлять	represent
завтра	tomorrow
объяснить	explained
пустой	empty
произнести	Pronounce
человеческий	human
нравиться	like
однажды	one day
мимо	by
иначе	otherwise
существовать	exist
класс	class
удаться	work out
толстый	fat
цель	target
сквозь	through
прийтись	to come
чистый	clean
знать	know
прежний	former
профессор	Professor
господин	Mr.
счастье	happiness
худой	thin
дух	spirit
план	plan
чужой	foreign
зал	Hall
представить	imagine
особый	special
директор	director
бывший	former
память	memory
близкий	close
сей	this
результат	result
больной	sick
данный	the
кстати	by the way
назвать	call
след	track
улыбаться	smile
бутылка	bottle
трудно	difficult
условие	condition
прежде	before
ум	mind
улыбнуться	smile
процесс	process
картина	picture
вместо	instead
старший	older
центр	Centre
подобный	like
возможно	perhaps
около	about
смеяться	laugh
сто	hundred
будущее	future
хватать	suffice
число	number
всякое	all
рубль	ruble
почувствовать	feel
принести	bring
вера	Vera
вовсе	all
удар	hit
телефон	phone
колено	knee
согласиться	accept
коридор	corridor
мужик	muzhik
правый	right
автор	author
холодно	cold
хватить	suffice
многие	many
встреча	a meeting
кабинет	cabinet
документ	document
самолет	aircraft
вниз	down
принимать	accept
игра	a game
рассказ	story
хлеб	bread
развитие	development
убить	kill
родной	native
открытыйоткрыто	открыто
менее	less
предложить	offer
желтый	yellow
приходиться	fall
выпить	drink
крикнуть	cry
трубка	a tube
враг	enemy
показывать	show
двое	two
доктор	doctor
ладонь	palm
вызвать	cause
спокойно	quietly
попросить	ask
наука	the science
лейтенант	lieutenant
служба	service
оказываться	prove
привести	lead
сорок	forty
счет	score
возвращаться	return
золотой	gold
местный	local
кухня	kitchen
крупный	large
решение	decision
молодая	young
тридцать	thirty
роман	novel
требовать	require
компания	company
частый	frequent
российский	Russian
рабочий	working
потерять	lose
течение	flow
синий	blue
столько	so many
теплый	warm
метр	meter
достать	get
железный	iron
институт	Institute of
сообщить	to report
интерес	interest
обычный	normal
появляться	appear
упасть	fall
остальной	rest
половина	half
московский	Moscow
шесть	six
получиться	get
качество	quality
бой	the battle
шея	neck
вон	out
идея	idea
видимо	apparently
достаточно	enough
провести	conduct
важно	important
трава	grass
дед	grandfather
сознание	consciousness
родитель	parent
простить	to forgive
бить	beat
чай	tea
поздний	late
кивнуть	nod
род	kind
исчезнуть	disappear
тонкий	thin
немецкий	German
звук	sound
отдать	pay
магазин	score
президент	the president
поэт	poet
спасибо	Thank you
болезнь	disease
событие	event
помочь	help
кожа	leather
лист	sheet
слать	send
вспоминать	remember
прекрасный	beautiful
слеза	a tear
надежда	hope
молча	silently
сильно	strong
верныйверно	vernyyverno
литература	literature
оружие	weapon
готовый	ready
запах	smell
неожиданно	suddenly
вчера	yesterday
вздохнуть	breathe
роль	role
рост	growth
природа	nature
политический	political
точка	dot
звезда	star
петь	sing
садиться	sit down
фамилия	surname
характер	character
пожалуйста	you are welcome
выше	higher
офицер	Officer
толпа	crowd
перестать	stop
придтись	to come
уровень	level
неизвестный	unknown
кресло	armchair
баба	woman
секунда	second
пожаловать	grant
банк	bank
опыт	an experience
тихий	quiet
поскольку	because the
сапог	boot
правило	rule
стекло	glass
получать	get
внутренний	interior
дочь	daughter
называться	be called
надеяться	hope
член	member
протянуть	extend
государственный	state
десяток	ten
глубоко	deep
цветок	flower
ах	Oh
желание	a wish
дождь	rain
впереди	ahead
подходить	suit
много	a lot of
лоб	forehead
улыбка	smile
борьба	fight
ворот	the gate
ящик	box
этаж	floor
служить	serve
вновь	again
голубой	blue
нечего	there is nothing
революция	revolution
впервые	first
сосед	neighbor
сестра	sister
долгий	long
чей	whose
поверить	to believe
ситуация	situation
взглянуть	glance
слабый	weak
количество	quantity
вызывать	call
уверенный	sure
выход	exit
совет	council
дурак	fool
любимый	favorite
союз	union
лето	summer
ожидать	expect
пришлый	alien
висеть	hang
граница	border
цвет	Colour
серьёзный	serious
создать	create
интересно	interesting
свобода	freedom
зато	but
стул	chair
уехать	leave
поезд	a train
музыка	music
тень	shadow
лошадь	horse
поле	field
выглядеть	to look like
учиться	study
левый	left
разговаривать	speak
детский	baby
тип	a type
суд	court
связанный	connected
горячий	hot
площадь	area
помогать	to help
счастливый	happy
повернуться	to turn
позволить	allow
встретить	meet
радость	joy
острый	acute
возраст	age
орган	organ
карта	map
входить	enter
обнаружить	discover
король	king
слава	glory
полковник	Col.
мелкий	small
бок	side
цена	price
информация	information
мозг	brain
удовольствие	pleasure
воля	will
область	region
крыша	roof
нести	bear
обратно	back
современный	modern
дама	lady
семь	seven
веселыйвесело	veselyyveselo
прислать	send
сад	garden
правительство	government
милый	cute
относиться	relate
возникать	arise
мол	breakwater
повторить	repeat
название	name
средний	average
пример	example
невозможно	impossible
зеркало	mirror
погибнуть	fall
американский	American
дым	smoke
гореть	burn
плакать	cry
весьма	very
факт	fact
двигаться	move
рыба	a fish
добавить	add
удивиться	wonder
бабушка	grandmother
вино	wine
ибо	for
учитель	teacher
действовать	act
осторожно	Caution
круг	a circle
папа	dad
правильно	correctly
недавно	recently
держаться	hold on
причем	and
лететь	fly
носить	wear
повод	occasion
лагерь	camp
птица	bird
корабль	ship
мнение	opinion
ночной	night
здоровый	healthy
зима	winter
сухой	dry
километр	kilometer
кровать	bed
привыкнуть	get used to it
прочее	other
свободный	free
лестница	stairs
неужели	really
обязательно	necessarily
вверх	up
детство	childhood
остров	Island
статья	article
позвонить	call
столь	so
мешать	prevent
водка	vodka
темнота	darkness
возникнуть	occur
способный	capable
станция	station
желать	want
попробовать	try
получаться	obtained
гражданин	citizen
странно	strangely
вскоре	soon
команда	command
заболевание	disease
живот	stomach
ставить	put
ради	for
тишина	silence
понятно	understandably
фронт	front
щека	cheek
страшно	fearfully
район	area
наверно	maybe
проводить	spend
выражение	expression
слегка	slightly
мешок	bag
обещать	promise
дорогойдорого	dorogoydorogo
судить	judge
большинство	most
собраться	gather
управление	control
колоть	prick
мокрый	wet
приказ	order
прямой	straight
закричать	shout
кончиться	come to an end
куст	bush
стрелять	shoot
художник	artist
знак	sign
завод	factory
кулак	fist
использовать	use
стакан	glass
пахнуть	smell
отсюда	here
рот	mouth
пора	it is time
передать	transfer to
лечение	treatment
высший	higher
сутки	day
вставать	get up
операция	operation
пространство	space
спокойный	calm
одежда	clothes
кусок	a piece
тема	subject
животный	animal
снимать	take off
искусство	art
умный	clever
малый	small
курс	course
звонить	call
очередной	next
чудо	miracle
ощущение	feeling
крайне	extremely
напоминать	remind
придумать	come up
падать	fall
здание	building
свежий	fresh
поговорить	talk
начинаться	start off
милиция	militia
приказать	to order
несмотря	despite
оттуда	thence
засмеяться	burst out laughing
волна	wave
задача	a task
касаться	touch
старуха	old woman
войско	army
срок	time
ужас	horror
узкий	narrow
материал	material
приняться	adopt
нормально	fine
крик	cry
знание	knowledge
трое	three
четвёртый	fourth
шум	noise
заставить	make
автомат	machine
резко	sharp
тетя	aunt
впечатление	impression
пауза	pause
глубина	depth
доллар	dollar
сотня	a hundred
виноватыйвиновато	vinovatyyvinovato
студент	student
боевой	combat
очко	point
нож	knife
подниматься	up
мировой	world
предмет	subject
плохой	bad
майор	Maj.
ударить	bump
разуметься	understand
точный	accurate
всякий	any
деятельность	activity
инженер	engineer
программа	program
костюм	costume
женский	female
крепко	firmly
театр	theater
встречаться	meet
различный	different
хвост	tail
танк	tank
социальный	social
мёртвый	dead
попытаться	to attempt
явно	clearly
журнал	Journal
конь	horse
схватить	catch
вдоль	along
стихи	poems
степень	power
отказаться	refuse
вытащить	pull
предлагать	offer
фигура	figure
ключ	key
черт	heck
отправиться	go
побежать	run
вагон	railway carriage
культура	culture
курить	smoke
боец	fighter
западный	west
фильм	film
восемь	eight 
открывать	open
зайти	go
немедленно	immediately
замечать	notice
пыль	dust
закончить	complete
мягко	soft
труба	trumpet
редкий	rare
миллион	million
следить	follow
масса	weight
пятьдесят	fifty
обстоятельство	circumstance
всякий	any
одновременно	at the same time
броситься	dash
пошло	gone
круглый	round
штаб	headquarters
слух	hearing
голый	naked
закрыть	close
линия	line
лодка	a boat
наоборот	conversely
даль	distance
председатель	chairman
понравиться	please
обратиться	apply
период	period
организм	organism
отдел	Department
весна	Spring
обед	dinner
значение	value
дно	bottom
фотография	the photo
некий	some
успех	success
грязно	dirtily
естественно	naturally
велеть	enjoin
сцена	scene
билет	ticket
состав	composition
знаменитый	famous
лишний	excess
честь	honor
иметься	exist
смех	laugh
СССР	the USSR
деревянный	wood
опустить	lower
родиться	be born
способ	process
спасти	save
зрение	vision
английский	English
отдельный	separate
извинить	excuse
громко	loud
объявить	announce
запад	west
Германия	Germany
обращаться	treat
население	population
беда	trouble
спешить	hurry
еда	food
поздно	late
специальный	special
наблюдать	watch
еврей	Jew
ой	Oh
суметь	manage
обернуться	turn out
министр	Minister
фирма	firm
проснуться	wake up
организация	organization
принцип	principle
направление	direction
гораздо	much
мастер	master
подождать	wait
светло	light
ошибка	error
высота	height
существо	being
заговорить	talk
мальчишка	urchin
пользоваться	use
научный	scientific
повторять	to repeat
ярко	bright
несколько	several
учить	learn
взяться	take
бегать	run
господь	Lord
общественный	public
устроить	to arrange
дышать	breathe
лечь	lie down
США	USA
камера	camera
победа	victory
учёный	scientist
состоять	consist
заходить	call
человечество	humanity
фраза	phrase
внимательно	attentively
считаться	consider
вероятно	probably
соседний	neighboring
замок	Castle
рыжий	red
ездить	ride
господи	Jesus
остановить	stop
встретиться	meet
явиться	appear
рынок	market
тяжело	heavy
злой	evil
клуб	club
привезти	bring
платить	to pay
кость	bone
дикий	wild
личность	personality
столица	capital
спасть	fall down
здоровье	health
здравствовать	long live
попытка	attempt
позволять	let
наиболее	most
постепенно	gradually
пятый	fifth
определённый	certain
читатель	reader
шутка	joke
исторический	historical
вслед	following
сотрудник	employee
внутри	within
собственно	properly
родина	birthplace
царь	king
насчет	about
страница	page
скорость	speed
зверь	beast
помочь	help
заявить	to declare
нечто	something
размер	the size
житель	a citizen
секретарь	Secretary
городской	urban
прекрасно	perfectly
торчать	sticking up
многое	much
Америка	America
сигарета	cigarette
полностью	fully
пиво	beer
прием	reception
противник	enemy
образование	education
продукт	product
поймать	to catch
пуля	bullet
книжка	book
дальний	further
экономический	economic
представитель	representative
собирать	collect
видимый	visible
производство	production
больница	hospital
ресторан	a restaurant
находить	find
диван	sofa
дыхание	breath
тюрьма	jail
лёгкое	lung
мясо	meat
внизу	at the bottom
кошка	cat
взрослый	adult
отсутствие	lack of
настроение	mood
собрать	gather
наступить	come
покой	peace
тянуть	to pull
народный	popular
процент	percent
постоянно	constantly
бросать	throw
мечтать	dream
захотеть	wish
автобус	bus
восток	East
оставлять	leave
усмехнуться	smile
эхо	echo
примерно	about
автомобиль	car
внешне	externally
технический	technical
пропасть	gulf
выдержать	withstand
миг	moment
отряд	squad
сверху	from above
настолько	so
встречать	meet
пускать	let
ясный	clear
занятие	occupation
реальный	real
задний	rear
Европа	Europe
случайно	accidentally
артист	artist
сложный	complicated
планета	planet
порог	threshold
явление	phenomenon
отпустить	release
красота	beauty
воскликнуть	exclaim
напротив	in front of
дрожать	shake
палатка	tent
выбрать	choose
пьяный	drunk
рада	glad
доска	board
пистолет	pistol
пожать	shake
актер	actor
раздаться	go off
зря	for nothing
потолок	ceiling
постель	bed
навстречу	to meet
ближайший	nearest
сумка	a bag
мгновение	instant
праздник	celebration
густо	thick
мост	bridge
энергия	energy
начальство	authority
сожаление	regret
полтора	one and a half
объяснять	explain
обратить	pay
сунуть	shove
пятнадцать	fifteen 
разрешить	solve
участок	lot
жертва	victim
меч	sword
звонок	call
кино	cinema
признаться	admit
мороз	frost
составлять	make
бедный	poor
летний	summer
видать	see
адрес	address
закрытый	closed
горло	throat
костер	bonfire
жалко	miserably
кот	cat
бык	bull
трудный	difficult
текст	text
тепло	heat
занимать	take
песок	sand
больно	painfully
сомнение	doubt
территория	territory
тайна	secret
волк	wolf
терять	lose
приятель	friend
рукав	sleeve
дедушка	granddad
вскочить	jump
прочитать	read
честно	fair
масло	butter
постоянный	constant
всякая	every
существование	Existence
лезть	to climb
младший	Jr
отправить	to send
построить	to build
нервно	nervously
пустить	start up
рождение	birth
заглянуть	look in
проговорить	say
воспоминание	memory
проверить	check
болеть	hurt
тон	tone
понятие	notion
низко	low
далее	Further
вечно	eternally
песня	song
морской	nautical
крыло	wing
поднимать	lift up
розовый	pink
нарушение	violation
осень	autumn
положенный	put
туман	fog
Ленинград	Leningrad
платье	dress
представление	performance
изменение	change
вариант	option
шофер	chauffeur
опасный	dangerous
означать	mean
вход	entrance
практически	practically
нынешний	present
глупо	foolishly
национальный	National
чиновник	official
поверхность	surface
приятно	nicely
каменный	stone
говориться	they say
прочий	other
испытывать	test
рано	early
жениться	marry
аппарат	apparatus
церковь	church
ручка	a pen
оглянуться	look
пригласить	to invite
хозяйка	hostess
строго	strictly
принадлежать	belong
внезапно	suddenly
единый	single
дворец	palace
водитель	driver
строить	build
множество	a bunch of
перейти	go
столик	table
урок	lesson
древний	ancient
опасность	danger
повезти	get lucky
французский	French
поглядеть	look
горе	sorrow
честный	fair
способность	capacity
повернуть	to turn
остальное	rest
добраться	get
серьёзно	Really
признать	recognize
поступить	do
работник	employee
долг	debt
специалист	specialist
торопиться	rush
итак	so
центральный	central
телевизор	TV
зло	evil
вкус	taste
муха	fly
поиск	Search
старшина	petty officer
озеро	lake
чемодан	suitcase
вынуть	remove
сзади	behind
стоить	cost
предел	limit
музей	museum
пятно	spot
зона	zone
ученик	learner
навсегда	forever
толк	sense
полагать	believe
родственник	relative
источник	a source
угодный	pleasing
послушать	listen
колесо	wheel
грязь	mud
отметить	Mark
стен	wall
добро	good
капля	a drop
экран	screen
руководитель	head
инспектор	inspector
удивление	surprise
утверждать	affirm
молоко	milk
очевидно	obviously
отличаться	differ
предложение	sentence
нету	no
среда	Wednesday
выскочить	pop out
одетый	dressed
площадка	area
приезжать	come
катить	roll
совесть	conscience
кофе	coffee
штаны	pants
охота	hunting
бровь	eyebrow
расти	grow
список	list
ниже	below
вернуть	return
зависеть	depend
ствол	trunk
основание	base
северный	northern
познакомиться	become acquainted
поведение	behavior
жалить	sting
найтись	be found
делаться	make
догадаться	guess
дальнейший	further
прожить	live
усилие	an effort
гулять	walk
клетка	cell
разобраться	sort out
обращать	convert
верхний	upper
обстановка	situation
температура	temperature
вывод	conclusion
абсолютно	absolutely
предприятие	company
принятый	accepted
отдавать	give away
сходить	descend
подарок	gift
звучать	sound
отделение	office
волноваться	worry
нижний	lower
штука	thing
защита	protection
вряд	unlikely
выстрел	shot
тотчас	immediately
суть	heart
труп	corpse
основа	the basis
подать	tax
домашний	home
готовить	Cook
участие	participation
жалеть	pity
фон	background
признак	sign
врать	lie
возразить	object
дача	country house
обо	about
довольный	satisfied
готовиться	prepare
слой	layer
охрана	security
превратиться	turn
милиционер	militiaman
портрет	portrait
терпеть	bear
махнуть	wave
шкаф	cupboard
вес	the weight
холод	cold
определить	determine
выпустить	release
тревога	anxiety
выступать	protrude
полок	shelves
куртка	jacket
спустя	after
отчего	from what
изба	cottage
редко	rarely
вершина	vertex
тайный	secret
занятый	busy
рассматривать	to consider
отойти	move away
вырасти	grow
Париж	Paris
убийство	murder
рубашка	shirt
ох	Oh
хозяйство	economy
парк	a park
перевести	translate
режим	mode
руководство	leadership
посадить	seat
преступление	a crime
стенка	wall
орать	scream
кругом	round
обойтись	do
луна	moon
богатый	rich
гостиница	hotel
беседа	conversation
твердый	solid
полк	regiment
выдать	issue
лапа	paw
воевать	fight
останавливаться	stop
никуда	nowhere
обладать	have
продать	sell
спорить	argue
солнечный	solar
забор	fence
больший	more
пост	fast
полезть	start to climb
печально	sorrowfully
выполнять	perform
требоваться	need
бледный	pale
умирать	die
шапка	a cap
дойти	reach
успокоиться	calm down
университет	university
бабка	head
журналист	journalist
должность	position
приближаться	approach
истина	true
раствор	solution
газ	gas
позиция	position
летать	to fly
неожиданный	unexpected
убивать	kill
появление	appearance
глухойглухо	gluhoygluho
обыкновенный	ordinary
двинуться	advance
решительно	decidedly
спуститься	descend
песнь	song
облако	cloud
морда	muzzle
записка	a note
иностранный	foreign
незнакомый	unfamiliar
установить	establish
забывать	forget
позвать	call
физический	physical
ус	mustache
помещение	room
испугаться	wind
плащ	cloak
еле	hardly
темно	dark
подъезд	access
съесть	eat
прочесть	read
следователь	investigator
двенадцать	twelve
задуматься	think
решать	decide
особенный	special
подарить	give
измениться	change
платок	shawl
мощный	powerful
середина	middle
сумасшедший	crazy
наверняка	for sure
здорово	awesome
напряжение	voltage
могила	grave
тоска	yearning
приводить	drive
удивляться	be surprised
буквально	literally
борт	board
забрать	pick up
грех	sin
несчастный	unhappy
строй	formation
занять	take
исследование	study
доказать	prove
буква	letter
реакция	reaction
варить	cook
мужской	male
резкий	cutting
пила	saw
литературный	literary
изменить	amend
обезьяна	a monkey
бригада	brigade
ловить	catch
остаток	the balance
стремиться	seek
пункт	paragraph
тянуться	drag
локоть	elbow
обязанный	bound
краска	paint
разница	difference
расстояние	distance
кружок	circle
пожилой	elderly
непонятно	unclear
окончательно	finally
Дон	Don
заставлять	make
удивительный	astonishing
страдать	suffer
седой	gray
политика	policy
поколение	generation
ожидание	expectation
записать	record
фонарь	lamp
куча	heap
полоса	band
страсть	passion
сержант	sergeant
святой	St
повесть	story
шепот	whisper
теория	theory
интересовать	interest
чисто	purely
пояс	belt
близко	close
включить	enable
поразить	hit
вокзал	railway station
вещество	substance
частный	private
корень	root
помолчать	be silent
столовый	table
ткань	the cloth
открыться	open
поток	flow
вынужденный	compelled
полиция	police
стыдный	shameful
база	base
слышно	heard
строгий	strict
шинель	overcoat
блестящий	brilliant
выбор	selection
сведение	reduction
комиссия	commission
направить	submit
палка	stick
запомнить	remember
бороться	fight
везти	carry
колонна	column
лёд	ice
замечательный	great
надпись	inscription
одинокий	alone
пиджак	a jacket
тарелка	plate
научиться	learn
пища	food
назначить	appoint
подруга	friend
выбирать	to choose
взрыв	explosion
сущность	essence
батарея	battery
техника	equipment
пастух	shepherd
напомнить	recall
сомневаться	doubt
крыльцо	porch
радоваться	rejoice
покрыть	cover by
глянуть	glance
значительно	much
захватить	grab
вождь	leader
восточный	Oriental
приносить	bring
международный	international
необходимость	necessity
оттого	that is why
духовный	spiritual
голод	hunger
девица	damsel
временный	temporary
составить	compose
ровно	smooth
мечта	dream
кольцо	ring
ага	aha
дочка	daughter
королева	queen
картошка	potato
достоинство	dignity
медведь	bear
содержание	content
проект	project
костить	Costa
согласный	consonant
покупать	buy
сперва	first
юный	young
любопытство	curiosity
создание	creature
паспорт	passport
двести	two hundred
коллега	colleague
девчонка	gal
луч	Ray
стучать	knock
коммунист	communist
просьба	request
домик	lodge
полчаса	half an hour
железо	iron
отличие	distinction
менять	change
мгновенно	instantly
пес	dog
разглядывать	examine
горько	bitterly
орудие	weapon
специально	specially
сказка	fairy tale
закурить	to smoke
семейный	family
устать	get tired
прикрыть	cover
твёрдо	firmly
молодец	well done
замолчать	fall silent
завести	make
прибыть	to arrive
собрание	collection
девять	nine 
слон	elephant
подтвердить	confirm
юноша	youth
сойти	get
поступать	do
крутойкруто	krutoykruto
валить	throw
объект	an object
убитый	killed
сравнение	comparison
справа	on right
благородный	noble
океан	ocean
поселок	village
тайга	taiga
борода	beard
пачка	pack
надоесть	bother
привычка	habit
сумма	sum
вывести	withdraw
прыгать	jump
создавать	create
грубыйгрубо	grubyygrubo
поездка	Trip
убедиться	make sure
ненавидеть	hate
заявление	statement
поражение	defeat
август	August
привычный	habitual
официально	officially
передний	front
север	north
шляпа	hat
изо	every
молчание	silence
исчезать	disappear
эй	Hey
топор	ax
ощущать	feel
тащить	drag
брюки	pants
соответствующий	appropriate
элемент	element
одеяло	a blanket
мотор	motor
везде	everywhere
дружба	friendship
безопасность	security
скрывать	hide
совершить	commit
крест	cross
земной	terrestrial
школьный	school
замереть	freeze
прозрачный	transparent
подавать	submit
истинный	true
кабина	cabin
пальто	coat
восторг	delight
экономика	economy
забота	care
произвести	make
дождаться	wait for
талант	talent
плыть	swim
запись	record
ведро	bucket
крестьянин	peasant
поворот	turn
подробность	detail
столб	pole
канал	channel
пассажир	passenger
выполнить	perform
устройство	device
благодаря	thanks
направиться	head
влияние	effect
ракета	rocket
гражданский	civil
шутить	tell jokes
смена	change
случаться	happen
спрятать	hide
предстоять	await
затылок	nape
юг	south
эпоха	era
товар	product
проклятый	damn
ветка	branch
кормить	feed
продолжаться	continue
разведчик	scout
отлично	excellent
боже	Christ
молодость	youth
отдыхать	relax
октябрь	October
широко	wide
храм	temple
сдать	pass
шестой	sixth
жаловаться	to complain
скала	rock
расчёт	calculation
решиться	decide
грозный	formidable
сделаться	to become
обида	offense
наступать	tread
скрыться	hide
огород	garden
насколько	to what extent
запас	stock
особенность	feature
уезжать	leave
заняться	do
шар	ball
печка	stove
неприятно	unpleasantly
могучий	powerful
заранее	beforehand
открытие	opening
переходить	move
орден	decoration
попадать	fall
ботинок	shoe
польза	benefit
печать	print
пот	sweat
корпус	housing
склад	stock
компьютер	a computer
слева	left
уважать	respect
женить	marry
рана	wound
ложиться	fall
коробка	box
секрет	secret
седьмой	seventh
холм	Hill
лесной	forest
ремень	belt
таков	such
произведение	composition
цифра	numeral
привет	Hi
телефонный	telephone
помощник	assistant
полет	flight
пожар	fire
корова	cow
глупость	folly
расположить	positioned
посидеть	sit
налить	pour
симптом	symptom
сообразить	consider
южный	south
бумажка	slip of paper
радио	radio
торопливый	hurried
удаваться	pan out
ха	Ha
профессия	profession
послышаться	be heard
ровный	smooth
старинный	old
разведка	intelligence service
свидетель	witness
указать	specify
халат	bathrobe
сегодняшний	today
зимний	winter
тьма	dark
повести	story
сообщение	message
гроб	coffin
подхватить	pick up
яма	pit
позади	behind
жест	gesture
устраивать	arrange
шоссе	highway
участвовать	participate
уважение	respect
цепь	chain
подвал	basement
некогда	once
сохранить	retain
лампа	lamp
закрывать	close
доля	share
неплохо	not bad
смешно	funny
понадобиться	would need
старушка	old woman
покачать	shake
выясниться	found out
уничтожить	destroy
отвести	take
гриб	mushroom
бродить	to roam
погода	weather
памятник	monument
жар	heat
валяться	wallow
кожаный	leather
механизм	mechanism
Израиль	Israel
мирно	peaceably
потеря	a loss
произносить	pronounce
контроль	control
профессиональный	professional
дверца	door
предупредить	warn
добиться	to achieve
норма	norm
ложка	a spoon
зарплата	salary
веревка	rope
метода	method
исключение	an exception
убрать	clean
волнение	excitement
поддерживать	support
продавать	sell
нежно	gently
баня	bath
путем	by
повесить	hang
ужин	dinner
март	March
оглядываться	look back
сигнал	signal
сыграть	play
библиотека	library
услать	sent away
махать	wave
ЦК	CC
предполагать	assume
заметно	noticeably
сеть	net
коричневый	brown
тщательно	carefully
нерв	nerve
вертолет	helicopter
сладкий	sweet
лекарство	medicine
рассчитывать	expect
запретить	forbid
кладбище	cemetery
переход	transition
сообщать	report
функция	function
перебить	kill
пулемет	machine gun
металлический	metal
батальон	battalion
грузовик	truck
радостно	joyfully
император	emperor
обидеться	take umbrage
башня	tower
сырой	raw
инструмент	tool
вынести	bear
мелочь	trifle
жёстко	hard
присутствие	presence
разбитый	broken
поглядывать	keep an eye on
структура	structure
отозваться	to respond
бесконечно	infinitely
ружье	gun
обрадоваться	rejoice
участник	participant
попасться	get caught
задание	the task
пробормотать	mutter
покинуть	leave
перо	pen
сфера	sphere
судья	judge
жизненный	vital
кончить	come
листок	sheet
равный	equal
ужасный	terrible
отдых	recreation
применять	use
непременно	certainly
золото	gold
угроза	a threat
доложить	report
яблоко	an Apple
меняться	change
обратный	back
путешествие	journey
традиция	tradition
полезный	useful
Франция	France
гнать	drive
выяснить	to figure out
драться	fight
раненый	wounded
депутат	deputy
захотеться	wish
американец	American
производить	produce
нигде	nowhere
знакомство	acquaintance
заснуть	fall asleep
свернуть	turn
задумчиво	reflectively
подозревать	suspect
скромный	modest
спускаться	to go down
следствие	result
медицинский	medical
договориться	reach an agreement
яйцо	egg
поступок	act
преступник	criminal
проверять	check
присесть	take a seat
звание	rank
дрова	firewood
удобный	comfortable
аккуратно	carefully
подушка	pillow
бег	run
тетка	aunt
пропустить	skip
дивизия	division
коньяк	cognac
др	etc.
распахнуть	throw open
исключительно	exclusively
горизонт	horizon
китайский	Chinese
ползти	crawl
выбраться	out
мрачно	gloomily
деталь	detail
контакт	contact
жук	beetle
шеф	boss
Петербург	Petersburg
правильный	correct
погодить	wait a little
новость	news
утренний	morning
гений	genius
передача	broadcast
редакция	edition
опуститься	descend
декабрь	December
публика	public
колхоз	kolkhoz
свадьба	wedding
лук	bow
городок	town
немало	some
бандит	bandit
москвич	muscovite
лаборатория	laboratory
прекратить	terminate
согласно	according to
справиться	cope
молодёжь	the youth
ноябрь	November
строительство	building
прислушиваться	listen
пакет	package
пенсия	pension
постараться	try
ценность	value
заяц	hare
сэр	sir
желудок	stomach
слабость	weakness
танец	dance
изучать	learn
удивительно	surprisingly
пилить	to nag
князь	prince
партийный	party
бомба	bomb
воин	warrior
подписать	sign
стрелок	shooter
посылать	send
комитет	Committee
карточка	card
итог	result
девка	wench
воображение	imagination
душевный	soulful
плотный	dense
танцевать	dance
склон	slope
действительность	reality
объяснение	explanation
серебряный	silver
подобрать	pick up
незаметно	insensibly
осветить	highlight
дешевый	cheap
многочисленный	numerous
степь	steppe
стеклянный	glass
вор	thief
внук	grandson
голодный	hungry
винтовка	rifle
лев	a lion
тяжесть	weight
приобрести	acquire
оборона	defense
ужасно	terribly
огонек	twinkle
поинтересоваться	ask
вечерний	evening
заорать	yell
трогать	touch
задержать	delay
подбородок	chin
стиль	style
вещий	prophetic
редактор	editor
потребовать	demand
щель	slit
вслух	aloud
блестеть	shine
противоположный	opposite
давление	pressure
коммунистический	communist
режиссер	producer
дар	gift
метро	Metro
шанс	chance
конкретный	specific
наблюдение	watching
май	May
усесться	take a seat
сиять	shine
туча	cloud
стоящий	standing
вырваться	escape
отвернуться	to turn away
дума	thought
закончиться	end
клиент	client
двигатель	engine
сентябрь	September
дежурный	duty
бормотать	mutter
завтрак	breakfast
состояться	take place
рыбак	fisherman
взвод	platoon
особо	specially
поправить	correct
альбом	album
болото	swamp
ответственность	a responsibility
ощутить	experience
беспокоиться	worry
пламя	flame
задавать	set
выдавать	issue
полететь	fly
художественный	art
отдохнуть	relax
снаряд	shell
марка	mark
заместитель	deputy
папка	folder
отказываться	refuse
концерт	concert
творческий	creative
разум	mind
волшебный	magic
МК	MK
пояснить	explained
активный	active
услуга	service
белье	linen
прощать	forgive
благо	good
ангел	angel
шуметь	make noise
одинаковый	same
толь	roofing felt
мина	mine
модель	model
массовый	mass
разрешение	resolution
наличие	Availability
доноситься	be heard
этап	stage
описать	describe the
невольно	unwittingly
козёл	goat
возвращение	return
класть	put
шагать	step
идиот	idiot
ненависть	hatred
победить	beat
плавать	to swim
лётчик	pilot
лекция	lecture
смелый	bold
случайный	random
каков	what
печь	bake
разобрать	disassemble
государь	prince
замуж	marry
верх	top
изображение	picture
моряк	sailor
речка	small river
республика	republic
гордость	pride
бревно	log
невеста	bride
потянуться	stretch
кривой	crooked
посреди	midst
предположить	suggest
прибор	instrument
кандидат	candidate
портфель	portfolio
доставить	deliver
ошибиться	slip up
разбудить	to wake
невидимый	invisible
виза	visa
гибель	death
прятать	hide
карьера	career
водить	lead
малыш	kid
пробовать	sample
заплатить	pay
назначение	appointment
гвоздь	nail
кафе	a cafe
убийца	assassin
неведомый	unbeknownst
японский	Japanese
обязанность	duty
отель	hotel
обнять	hug
допустимый	permissible
заглядывать	peek
подготовка	preparation
последствие	aftermath
красавица	beauty
ковер	carpet
выбросить	throw
анализ	analysis
устроиться	get
собственность	own
оценить	estimate
немножко	slightly
хлопнуть	pop
родить	give birth
уставиться	stare
отечественный	domestic
снизу	from below
прокурор	prosecutor
карандаш	pencil
принц	prince
слышаться	be heard
лидер	leader
представляться	seem
спирт	alcohol
обеспечить	provide
бизнес	business
иностранец	foreigner
биться	beat
достигнуть	reach
выпускать	release
поп	pop
койка	berth
приготовить	cook
жестокий	cruel
руль	steering wheel
требование	demand
сволочь	scum
развиваться	develop
увы	Alas
меж	between
пожалеть	take pity
вызов	call
спутник	satellite
обойти	circumvent
оторвать	tear
отчаяние	despair
применение	application
заключаться	lie
организовать	organize
мука	flour
приглашать	invite
распоряжение	disposal
еврейский	Jewish
галстук	tie
поддержать	support
сбить	knock down
заработать	win
госпиталь	hospital
течь	flow
материальный	material
училище	school
последовать	follow
отличный	a great
стук	knocking
гигантский	giant
скандал	scandal
ледяной	ice
отпуск	holiday
полагаться	rely
доставать	get
продолжить	continue
суровый	severe
рукопись	manuscript
дура	fool
полицейский	policeman
кадр	frame
сиденье	seat
ныне	now
указывать	specify
экспедиция	expedition
спичка	match
сложиться	emerge
таинственный	mysterious
брак	marriage
посуда	dishes
снежный	snow
горный	mountain
справедливость	justice
лопата	shovel
набрать	dial
кнопка	button
предпочитать	prefer
необыкновенный	unusual
научить	teach
мистер	Mister
дорожка	track
проявление	manifestation
такси	Taxi
внутрь	inside
ловко	cunningly
хрен	horseradish
владелец	owner
свинья	pig
плод	fetus
интересоваться	be interested in
расстрелять	shoot
побывать	visit
вовремя	during
заплакать	begin to cry
окружить	surround
заседание	meeting
патрон	cartridge
охотно	willingly
раскрыть	to uncover
агент	agent
супруг	spouse
январь	January
соль	salt
роза	rose flower
развести	breed
опытный	experienced
комиссар	commissioner
свидание	date
воздушный	air
вооружённый	armed
негромко	in a low voice
питание	food
неловко	uncomfortable
деловой	business
кролик	rabbit
шкура	skin
политик	politician
грохот	bolt
переживать	live through
финансовый	financial
украсть	steal
слыхать	hear anything
неприятность	trouble
достойный	worthy
шестьдесят	sixty
электрический	electric
успевать	have time
пережить	been through
контора	office
по-русски	in Russian
возражать	mind
суп	soup
европейский	European
палата	ward
сплошной	solid
мода	fashion
кусочек	a piece
понятный	clear
старичок	the old man
потянуть	pull
сорвать	wreck
июнь	June
порт	port
комплекс	complex
спортивный	sports
поддержка	support
блеск	shine
уснуть	fall asleep
потребность	need
лента	tape
громадный	great
сопровождать	accompany
открываться	open
бочок	flank
музыкант	musician
договор	agreement
поход	campaign
подготовить	prepare
мастерская	workshop
защищать	protect
происхождение	origin
спора	spore
ломать	break
пушок	down
рубаха	shirt
оболочка	shell
вступить	start
недалеко	near
выставить	exhibit
прижать	press
препарат	a drug
передавать	transmit
догадываться	guess
недостаток	shortcoming
министерство	Ministry
выступить	come out
отрезать	cut off
искра	spark
дурной	bad
трус	coward
заключение	conclusion
экзамен	exam
скамейка	bench
хохотать	laugh
охотник	hunter
разглядеть	discern
пустыня	desert
разбираться	sort out
понимание	understanding
дважды	twice
пресса	press
молния	lightning
воспользоваться	take advantage of
психический	mental
достаться	get all
сахар	sugar
реальность	reality
одиночество	loneliness
социализм	socialism
судно	vessel
туалет	restroom
окружающее	surrounding
якобы	allegedly
атмосфера	atmosphere
удача	luck
бросаться	rush up
оценка	evaluation
Волга	Volga
пароход	steamship
служебный	office
вне	out
остановка	stop
рыцарь	knight
академик	academician
пустота	emptiness
копейка	kopeck
версия	version
ножка	leg
деревенский	rustic
аккумулятор	battery
исключить	deleted
провожать	see off
собеседник	interlocutor
триста	three hundred
прошептать	whisper
плоский	flat
зритель	viewer
нынче	now
осмотреть	inspect
характерный	characteristic
военный	military
вздрогнуть	wince
старость	old age
цивилизация	civilization
посвятить	dedicate
перенести	postpone
драка	fight
лифт	elevator
тряпка	rag
колбаса	sausage
прервать	abort
отчет	report
каша	porridge
освободить	release
дьявол	devil
сарай	barn
использование	using
творчество	creation
неторопливый	leisurely
проход	passage
Чечня	chechnya
воробей	sparrow
учесть	take account
походить	resemble
относительно	on
подвести	take
рваться	tear
мышца	muscle
жирный	fatty
дожидаться	wait
рассвет	dawn
всерьез	seriously
кивать	beckon
коммунизм	communism
сбежать	elope
глоток	a sip
доказательство	evidence
ввести	enter
нация	nation
сердито	angrily
узел	node
грустный	sad
зависимость	addiction
груз	cargo
империя	empire
определять	determine the
комбат	Kombat
величина	value
крышка	cap
воздействие	effect
допустить	prevent
сбросить	reset
кирпич	brick
полюбить	love
глазок	peephole
содержать	contain
турист	tourist
де	de
обмен	exchange
всеобщий	general
перевод	transfer
четверо	four
стрела	arrow
уголок	corner
лишенный	free
превращаться	turn
лавка	shop
ласковый	gentle
поцеловать	kiss
блюдо	dish
арестовать	to arrest
оглядеть	look around
ток	current
славный	glorious
окоп	trench
демократия	democracy
рвать	rip
шевелиться	stir
свойство	property
рухнуть	collapse
посторонний	outsider
кончаться	finish
успокоить	reassure
рассуждать	reason
секретный	secret
приключение	adventure
искусственный	artificial
получение	receipt
ступенька	step
поза	pose
постучать	knock
штат	state
выборы	elections
носок	sock
сосна	Pine
олень	deer
сидя	sitting
доказывать	prove
перемена	turn
вытянуть	pull
бригадир	foreman
впоследствии	later
уверенность	confidence
сложить	fold
акция	stock
чрезвычайно	extremely
ранить	wound
половой	sexual
засыпать	fall asleep
доходить	reach
космический	space
жених	groom
неподалёку	Proximity
командовать	command
Китай	China
сломать	break
орел	eagle
сорваться	break away
развернуть	expand
дневник	a diary
музыкальный	musical
суббота	Saturday
повышение	increase
гимнастерка	blouse
грозить	threaten
обмануть	deceive
статус	status
посоветовать	give advice
папироса	cigarette
разойтись	break up
восьмой	eighth
убежать	escape
культурный	cultural
воскресенье	Sunday
собачий	canine
сохраниться	preserved
помешать	prevent
проводник	conductor
рюмка	glass
свеча	candle
рассмеяться	laugh
красиво	beautiful
светиться	shine
белок	protein
поначалу	at first
вдвоем	double
помимо	besides
вспыхнуть	flush
решетка	lattice
фактор	factor
слепой	blind
целовать	kiss
отказ	renouncement
волшебник	wizard
изредка	occasionally
нажать	press
заказать	to order
соответствовать	fit
решаться	decide
болтать	chat
указание	designation
доклад	report
нестись	rush
прочь	away
страдание	suffering
окончание	ending
строка	line
тротуар	sidewalk
конфликт	conflict
справка	reference
мебель	furniture
вежливо	politely
ноготь	nail
отнюдь	by no means
химический	chemical
сосуд	vessel
Корея	Korea
трудовой	labor
явный	clear
владеть	own
достижение	attainment
дополнительный	additional
асфальт	asphalt
заменить	replace the
челюсть	jaw
подвиг	feat
колдун	witch
наряд	finery
кончать	finish
письменный	writing
соображать	savvy
соглашаться	agree
скрытый	hidden
рисунок	drawing
прятаться	hide
плюс	a plus
попадаться	getting caught
частность	particular
жалость	a pity
транспорт	transport
наказание	punishment
изображать	represent
выражать	to express
образоваться	formed
способствовать	contribute
съезд	congress
заложить	establish
семьдесят	seventy
исходить	proceed
накануне	on the eve
окончить	finish
отчетливо	distinctly
рамка	frame
акт	Act
посетитель	visitor
долина	valley
невероятный	incredible
влажный	wet
вылезть	climb out
выпасть	fall
божий	divine
социалистический	socialist
обсуждать	discuss
очнуться	wake
рисковать	to risk
выступление	speech
гордиться	be proud
загадочный	mysterious
издание	edition
выразить	express
окружающий	ambient
чашка	a cup
соображение	consideration
жир	fat
миновать	pass
намерение	intention
жаркий	hot
спасать	save
ванная	bathroom
ложь	False
отходить	depart
кузнец	blacksmith
балкон	balcony
запереть	lock
полевой	field
допрос	examination
подходящий	suitable
спектакль	performance
предупреждать	warn
длительный	long
почва	the soil
легенда	legend
отыскать	find
оборачиваться	turn round
срочно	urgently
малейший	the slightest
жидкость	liquid
приемный	adoptive
охватить	cover
благодарить	thank
вздыхать	sigh
блок	block
усталость	fatigue
рисовать	draw
беседовать	talk
надеть	wear
небось	I suppose
поспешно	hastily
заключить	to conclude
надежный	reliable
нужда	need
окошко	window
гудеть	buzz
сюжет	plot
приличный	decent
генеральный	general
угадать	guess
хитрый	cunning
осколок	splinter
кинуться	throw oneself
дурацкий	foolish
сок	juice
будущий	future
испытать	test
усталый	tired
Кремль	Kremlin
мышка	mouse
эффект	Effect
пещера	cave
покраснеть	turn red
зад	ass
возиться	tinker
хранить	keep
небесный	heavenly
сменить	change
приподнять	lift
шагнуть	step
разрыв	gap
цех	shop
браться	undertake